_ _ _ _ _ _ _
_ W _ W _ W _
_ _ _ R F1 _ _
_ W _ W R W _
_ _ _ _ _ _ _
_ W _ W _ W _
_ _ _ _ _ _ B1